
NO ./path_to_the_north_texture
SO ./path_to_the_south_texture
WE ./path_to_the_west_texture
EA ./path_to_the_east_texture

F 255,255,0
C 255,255,128

11111111111111111111
10000000000000000001
100000N0000000000001
10000000000000000001
11110100000000001111
11000000011111101111
11011101010100101111
11000101010110101011
11000001000000000001
11111111111111111111
